111111111
1P0000001
101110101
101C00101
1C0010C01
10C010001
10C010C01
10C010C01
1C0110E01
111111111