11111111111
1P0000000E1
10101110101
1C0C1000011
10001011101
1C001000001
11111111111