1111111
1P00001
1011101
1C00101
1000C01
1C00C01
10000E1
1111111