111111
1P0C11
100C11
100E11
111111