111111111
1P0000001
101110101
101C00101
100010001
1C0110E01
111111111