1111111111111
1P000000000E1
1000111111101
1C00000000C01
1011111111101
1000000000001
1111111111111