111111111
1P0000001
111011101
1C0010001
100001111
1C00000E1
111111111