11111111
1P0000C1
10111101
1C000001
11101101
1001C0E1
11111111