11111
1P111
10111
1C1C1
1E011
11111