111111
1P0001
100C01
100C01
100101
111E11
111111