1111111
1P00001
1111101
1111101
1C10o01
1011011
1C000E1
1111111